{
  "0": "a",
  "1": "b",
  "2": "c",
  "3": "k",
  "4": "n",
  "5": "p",
  "6": "r",
  "7": "-",
  "8": "A",
  "9": "B",
  "10": "C",
  "11": "K",
  "12": "N",
  "13": "P",
  "14": "R"
}